0 0 0 0 0 0 0 0 0 0 0 0 0 0 0
t t t t t t t t t t t t t t t
b 0 0 0 0 0 0 0 0 0 0 0 0 0 b
b 0 0 0 0 0 0 0 0 t t 0 0 0 b
b 0 0 0 0 0 0 0 0 0 0 0 0 0 b
b 0 0 t t t t t t t t 0 0 0 b
b 0 0 t t 0 0 0 0 0 0 0 0 0 b
b 0 0 0 0 0 0 0 0 0 0 0 0 0 b
s s s s s s s s s s s s s s s
0 0 0 0 0 0 0 0 0 0 0 0 0 0 0