0 0 0 0 0 0 0 0 0 0 0 0 0 0 0
a a a a a a a a a a a a a a a
q 0 0 0 0 0 0 0 0 0 0 0 0 0 q
q 0 0 0 0 0 0 0 0 0 0 0 0 0 q
q z 0 0 z z z z z z z 0 0 z q
q 0 0 0 0 0 0 0 0 0 0 0 0 0 q
q z 0 0 z z z z z z z 0 0 z q
q 0 0 0 0 0 0 0 0 0 0 0 0 0 q
q z 0 0 z z z z z z z 0 0 z q
q a a a a a a a a a a a a a q